//MAP CONVERTED BY dmm2tgm.py THIS HEADER COMMENT PREVENTS RECONVERSION, DO NOT REMOVE
"a" = (
/turf/open/floor/rogue/grass,
/area/rogue/outdoors)
"d" = (
/turf/open/floor/rogue/greenstone/runed,
/area/rogue)
"h" = (
/turf/open/floor/rogue/greenstone,
/area/rogue/outdoors)
"k" = (
/obj/machinery/light/rogue/firebowl/standing/blue,
/turf/open/floor/rogue/greenstone,
/area/rogue)
"m" = (
/obj/machinery/light/rogue/firebowl/standing/blue,
/turf/open/floor/rogue/greenstone,
/area/rogue/outdoors)
"n" = (
/obj/machinery/light/rogue/wallfire/candle/blue/l,
/turf/open/floor/rogue/greenstone,
/area/rogue/outdoors)
"q" = (
/obj/structure/mineral_door/wood/deadbolt/arcyne/caster,
/turf/open/floor/rogue/greenstone,
/area/rogue/outdoors)
"r" = (
/turf/open/floor/rogue/greenstone,
/area/rogue)
"s" = (
/obj/structure/mineral_door/wood/deadbolt/arcyne/caster{
	dir = 8
	},
/turf/open/floor/rogue/greenstone,
/area/rogue/outdoors)
"v" = (
/obj/machinery/light/rogue/wallfire/candle/blue/r,
/turf/open/floor/rogue/greenstone/runed,
/area/rogue)
"w" = (
/obj/machinery/light/rogue/wallfire/candle/blue/r,
/turf/open/floor/rogue/greenstone,
/area/rogue)
"x" = (
/turf/open/floor/rogue,
/area/rogue)
"y" = (
/obj/structure/arcyne_wall/greater/caster,
/turf/open/floor/rogue/greenstone,
/area/rogue/outdoors)
"F" = (
/obj/machinery/light/rogue/wallfire/candle/blue/r,
/turf/open/floor/rogue/greenstone/runed,
/area/rogue/outdoors)
"H" = (
/obj/structure/mineral_door/wood/deadbolt/arcyne/caster{
	dir = 4
	},
/turf/open/floor/rogue/greenstone,
/area/rogue/outdoors)
"O" = (
/obj/structure/arcyne_wall/greater/caster,
/turf/open/floor/rogue/greenstone,
/area/rogue)
"Q" = (
/obj/machinery/light/rogue/wallfire/candle/blue/l,
/turf/open/floor/rogue/greenstone,
/area/rogue)
"R" = (
/turf/open/floor/rogue/greenstone/runed,
/area/rogue/outdoors)
"Y" = (
/obj/machinery/light/rogue/wallfire/candle/blue/r,
/turf/open/floor/rogue/greenstone,
/area/rogue/outdoors)

(1,1,1) = {"
a
y
y
y
y
y
q
y
y
y
y
y
a
"}
(2,1,1) = {"
y
y
h
n
R
h
h
h
R
n
h
y
y
"}
(3,1,1) = {"
y
h
R
y
y
y
H
y
y
y
R
h
y
"}
(4,1,1) = {"
y
h
y
y
h
R
h
h
y
y
y
R
y
"}
(5,1,1) = {"
y
R
y
m
R
h
h
h
h
m
y
h
y
"}
(6,1,1) = {"
y
h
y
R
h
h
h
R
h
h
y
h
y
"}
(7,1,1) = {"
y
h
y
R
R
R
R
R
R
R
y
R
y
"}
(8,1,1) = {"
y
R
y
R
h
h
h
R
h
h
y
h
y
"}
(9,1,1) = {"
y
h
y
m
R
h
h
h
h
m
y
R
y
"}
(10,1,1) = {"
y
h
y
y
h
R
h
h
y
y
y
h
y
"}
(11,1,1) = {"
y
h
R
y
y
y
s
y
y
y
R
h
y
"}
(12,1,1) = {"
y
y
h
Y
h
R
h
h
h
F
h
y
y
"}
(13,1,1) = {"
a
y
y
y
y
y
s
y
y
y
y
y
a
"}

(1,1,2) = {"
x
O
O
O
O
O
O
O
O
O
O
O
x
"}
(2,1,2) = {"
O
O
r
Q
d
r
r
r
d
Q
r
O
O
"}
(3,1,2) = {"
O
r
d
r
r
r
r
r
r
r
d
r
O
"}
(4,1,2) = {"
O
r
r
r
r
d
r
r
r
r
r
d
O
"}
(5,1,2) = {"
O
d
r
k
d
r
r
r
r
k
r
r
O
"}
(6,1,2) = {"
O
r
r
d
r
r
r
d
r
r
r
r
O
"}
(7,1,2) = {"
O
r
r
d
d
d
d
d
d
d
r
d
O
"}
(8,1,2) = {"
O
d
r
d
r
r
r
d
r
r
r
r
O
"}
(9,1,2) = {"
O
r
r
k
d
r
r
r
r
k
r
d
O
"}
(10,1,2) = {"
O
r
r
r
r
d
r
r
r
r
r
r
O
"}
(11,1,2) = {"
O
r
d
r
r
r
r
r
r
r
d
r
O
"}
(12,1,2) = {"
O
O
r
w
r
d
r
r
r
v
r
O
O
"}
(13,1,2) = {"
x
O
O
O
O
O
O
O
O
O
O
O
x
"}

(1,1,3) = {"
x
r
r
r
r
r
r
r
r
r
r
r
x
"}
(2,1,3) = {"
r
r
r
r
d
r
r
r
d
r
r
r
r
"}
(3,1,3) = {"
r
r
d
r
r
r
r
r
r
r
d
r
r
"}
(4,1,3) = {"
r
r
r
r
r
d
r
r
r
r
r
d
r
"}
(5,1,3) = {"
r
d
r
r
d
r
r
r
r
r
r
r
r
"}
(6,1,3) = {"
r
r
r
d
r
r
r
d
r
r
r
r
r
"}
(7,1,3) = {"
r
r
r
d
d
d
d
d
d
d
r
d
r
"}
(8,1,3) = {"
r
d
r
d
r
r
r
d
r
r
r
r
r
"}
(9,1,3) = {"
r
r
r
r
d
r
r
r
r
r
r
d
r
"}
(10,1,3) = {"
r
r
r
r
r
d
r
r
r
r
r
r
r
"}
(11,1,3) = {"
r
r
d
r
r
r
r
r
r
r
d
r
r
"}
(12,1,3) = {"
r
r
r
r
r
d
r
r
r
d
r
r
r
"}
(13,1,3) = {"
x
r
r
r
r
r
r
r
r
r
r
r
x
"}
